1,66;11,10;22,44;1,80;91,90;2,0;
1,0;1,0;1,0;1,0;1,0;3,0;
1,0;1,0;1,0;1,0;1,0;4,0;
1,0;1,0;1,0;1,0;1,0;5,0;
1,0;1,0;1,0;1,0;1,0;6,0;
1,0;1,0;1,0;1,0;1,0;7,0;
1,0;1,0;1,0;1,0;1,0;8,0;
1,0;1,0;1,0;1,0;1,0;9,0;
